11111111101
10000E00001
1P00C000001
11111111111
