11111111111
10000E000011
1P00C000001
11111111111
