1111111111
1PC0000001
100E000001
100000C001
1000000001
1111111111
