1111111111
1PC0000001
100E011001
100110C001
1000000C01
1111111111
